--------------------------------------------------------------------------------------------------------------------------------------------------------------------------------------------------------
--------------------------------------------------------------------------------------------------------------------------------------------------------------------------------------------------------
--------------------------------------------------------------------------------------------------------------------------------------------------------------------------------------------------------
--------------------------------------------------------------------------------------------------------------------------------------------------------------------------------------------------------
--------------------------------------------------------------------------------------------------------------------------------------------------------------------------------------------------------
--------------------------------------------------------------------------------------------------------------------------------------------------------------------------------------------------------
--------------------------------------------------------------------------------------------------------------------------------------------------------------------------------------------------------
-------------------------------------------------------------------------------------------------------------------------------------------------------------------------------------------------------v
-------------------------o-----------------------------------------------------------------------------------------------------------------------------------------------------------------------------f
-------------------------------------------------------------------------------------------------------------------------------------------------------------------------------------------------------f
-------------------------------------------------------------------------------------------------------------------------------------------------------------------------------------------------------f
--------------------------------------------------------------------------------------------------------------------------?----------------------------------------------------------------------------f
-------------------???---------------------------------------------------------------------------------------------------------------------------------------------------------------------------------f
-------------------------------------------------------------------------------------------------------------------------------------------------------------------------------------------------------f
m------------------------------------------------------------------------------------------------------------------------------------------------------------------------------------------------------X
XXXXXXXXXXXXXXXXXXX???XXXXXXXX---XXXXXXXXXXXXXXXXXXXXXXXXXXXXXXXXXXXXXXXXXXXXXXXXXXXXXXXXXXXXXXXXXXXXXXXXXXXXXXXXXXXXXXXXXXXXXXXXXXXXXXXXXXXXXXXXXXXXXXXXXXXXXXXXXXXXXXXXXXXXXXXXXXXXXXXXXXXXXXXXXXXXXXX
