--------------------------------------------------------------------------------------------------------------------------------------------------------------------------------------------------------
-----------o----------------------------------------------------------------------------------------------------------------------------------------------------------------?-------------------------B-
--------------------------------------------------------------------------------------------------------------------------------------------------------------------------------------------------------
----------------------------------------------------------------------------------------------------------------------------------------------------------------------------------------------T---------
-------------T--------------------------------------------------------------------------------------------------------------------------------------------------------------------------------|---------
------------X|---------------------------------------------------------------------------------------------------------------------------------------------------------------------?--T-------|---------
-----------XX|------------------------------------------------------------------------------------------------------------------------------------------------M-----------------------|-------|---------
----------XXX|--------------------------------------------------------------------------------------------------------------------------------------------------------------T---------|-------|--------v
---------XXXX|------------------------------------------------------------------------------------------------------------------------------------------------------------X-|---------|o------|--------f
--------XXXXX|---------------BBBB---------X---------------------------------------------------------------------------------------------------------------------------------|---------|-------|--------f
-------XXXTXX|------------o---------------XX-------------------------------------------------------------------------------------------------------------------------T------|----o----|-------|--------f
------XXXX|XX|----------------------------XXX------------------------------------------------------------------------------------------------------------------------|------|---------|--T----|--------f
-----XXXXX|XX|---------T------------------XXXX-----------------------------------------------------------------------------------------------------------------------|------|---------|--|----|--------f
----XXXTXX|XX|---------|------------------XXXXX----------------------------------------------------------------------------------------------------------------------|------|---------|--|----|--------f
m--XXXX|XX|XX|E---E---E|-------E---------EXXXXXX---------------------------------------------------------------------------------------------------------------------|------|---------|--|----|--------X
XXXXXXX|XX|XX|XXXXXXXXX|MXXXXXXXXXXXXXXXXXXXXXXXXXX-----XXXXXXXXXXXXXXXXXXXXXXXXXXXXXXXXXXXXXXXXXXXXXXXXXXXXXXXXXXXXXXXXXXXXXXXXXXXXXXXXXXXXXXXXXXXXXXXXXXXXXXXXXXXXX|XXXXXX|XXXXXXXXX|XX|XXXX|XXXXXXXXX
