--------------------------------------------------------------------------------------------------------------------------------------------------------------------------------------------------------
----------------------------------------------------------------------------------------------------------------------------------------------------------------------------?-------------------------B-
--------------------------------------------------------------------------------------------------------------------------------------------------------------------------------------------------------
----------------------------------------------------------------------------------------------------------------------------------------------------------------------------------------------T---------
-------------X--------------------------------------------------------------------------------------------------------------------------------------------------------------------------------|---------
------------XX---------------------------------------------------------------------------------------------------------------------------------------------------------------------?----------|---------
-----------XXX------------------------------------------------------------------------------------------------------------------------------------------------M-------------------------------|---------
----------XXXX--------------------------------------------------------------------------------------------------------------------------------------------------------------T-----------------|--------v
---------XXXXX------------------------------------------------------------------------------------------------------------------------------------------------------------X-|-----------------|--------f
--------XXXXXX--------------------------------------------------------------------------------------------------------------------------------------------------------------|-----------------|--------f
-------XXXXXXX--------------------------------------------------------------------------------------------------------------------------------------------------------------|----o------------|--------f
------XXXXXXXX--------------------------------------------------------------------------------------------------------------------------------------------------------------|-----------------|--------f
-----XXXXXXXXX--------------------------------------------------------------------------------------------------------------------------------------------------------------|-----------------|--------f
----XXXXXXXXXX--------------------------------------------------------------------------------------------------------------------------------------------------------------|-----------------|--------f
m--XXXXXXXXXXX--------------------------------------------------------------------------------------------------------------------------------------------------------------|-----------------|--------X
XXXXXXXXXXXXXXXXXXXXXXXXXXXXXXXXXXXXXXXXXXXXXXXXXXXXXXXXXXXXXXXXXXXXXXXXXXXXXXXXXXXXXXXXXXXXXXXXXXXXXXXXXXXXXXXXXXXXXXXXXXXXXXXXXXXXXXXXXXXXXXXXXXXXXXXXXXXXXXXXXXXXXXXXXXXX|XXXXXXXXXXXXXXXXX|XXXXXXXXX
