--------------------------------------------------------------------------------------------------------------------------------------------------------------------------------------------------------
----------------------------------------------------------------------------------------------------------------------------------------------------------------------------?---------------------------
--------------------------------------------------------------------------------------------------------------------------------------------------------------------------------------------------------
--------------------------------------------------------------------------------------------------------------------------------------------------------------------------------------------------------
-------------X------------------------------------------------------------------------------------------------------------------------------------------------------------------------------------------
------------XX---------------------------------------------------------------------------------------------------------------------------------------------------------------------?--------------------
-----------XXX------------------------------------------------------------------------------------------------------------------------------------------------------------------------------------------
----------XXXX-----------------------------------------------------------------------------------------------------------------------------------------------------------------------------------------v
---------XXXXX------------------------------------------------------------------------------------------------------------------------------------------------------------X----------------------------f
--------XXXXXX-----------------------------------------------------------------------------------------------------------------------------------------------------------------------------------------f
-------XXXXXXX-------------------------------------------------------------------------------------------------------------------------------------------------------------------o---------------------f
------XXXXXXXX-----------------------------------------------------------------------------------------------------------------------------------------------------------------------------------------f
-----XXXXXXXXX-----------------------------------------------------------------------------------------------------------------------------------------------------------------------------------------f
----XXXXXXXXXX-----------------------------------------------------------------------------------------------------------------------------------------------------------------------------------------f
m--XXXXXXXXXXX-----------------------------------------------------------------------------------------------------------------------------------------------------------------------------------------X
XXXXXXXXXXXXXXXXXXXXXXXXXXXXXXXXXXXXXXXXXXXXXXXXXXXXXXXXXXXXXXXXXXXXXXXXXXXXXXXXXXXXXXXXXXXXXXXXXXXXXXXXXXXXXXXXXXXXXXXXXXXXXXXXXXXXXXXXXXXXXXXXXXXXXXXXXXXXXXXXXXXXXXXXXXXXXXXXXXXXXXXXXXXXXXXXXXXXXXXX
