--------------------------------------------------------------------------------------------------------------------------------------------------------------------------------------------------------
--------------------------------------------------------------------------------------------------------------------------------------------------------------------------------------------------------
--------------------------------------------------------------------------------------------------------------------------------------------------------------------------------------------------------
--------------------------------------------------------------------------------------------------------------------------------------------------------------------------------------------------------
----------------------------------------------------------------------------------------------------X---------------------------------------------------------------------------------------------------
---------------------------------------------------------------------------------------------------XX---------------------------------------------------------------------------------------------------
------------------------------X-------------------------------------------------------------------XXX--------------------------------X------------------------------------------------------------------
-----------------------------XX------------------------------------------------------------------XXXT----------------------------------------------????------------------------------------------------v
----------------------------XXX-----------------------------------------------------------------XXXX|--------------------------------------------------------------------------------------------------f
---------------------------XXXX----------------------------------------------------------------XXXXX|--------------------------------------------------------------------------------------------------f
--------------------------XXXXX---------------------------------------------------------------XXXXXX|--------------------------------------------------------------------------------------------------f
-------------------------XXXXXX--------------------------------------------------------------XXXXXXX|--------------------------------------------------------------------------------------------------f
-------------------T----XXXXXXX-------------------------------------------------------------XXXXXXXX|----------------------XXX----------------------------XXXXXXX--------------------------------------f
--T----------------|---XXXXXXXX------------------------------------------------------------XXXXXXXXX|------------------------------------------------------------------------------------------------?-f
m-|----------------|--XXXXXXXXX---------------------E-----------E-------------------------XXXXXXXXXX|--------------------------------------------------------------------------------------------------X
XX|XXXXXXXXXXXXXXXX|XXXXXXXXXXXXXXXXXXXXXXXXXXXXXXXXXXXXXXXXXXXXXXXXXXXXXXXXXXXXXXXXXXXXXXXXXXXXXXXX|XXXXXXXXXXXXXXXXXXXXXXXXXXXXXXXXXXXXXXXX--------XXXX---XXXXXXXXXXXXXXXXXXXXXXXXXXXXXXXXXXXXXXXXXXXX
