--------------------------------------------------------------------------------------------------------------------------------------------------------------------------------------------------------
--------------------------------------------------------------------------------------------------------------------------------------------------------------------------------------------------------
--------------------------------------------------------------------------------------------------------------------------------------------------------------------------------------------------------
--------------------------------------------------------------------------------------------------------------------------------------------------------------------------------------------------------
----------------------------------------------------------------------------------------------------X---------------------------------------------------------------------------------------------------
---------------------------------------------------------------------------------------------------XX---------------------------------------------------------------------------------------------------
-----------------------------XX-------------------------------------------------------------------XXX--------------------------------X------------------------------------------------------------------
----------------------------XXX------------------------------------------------------------------XXXT----------------------------------------------????------------------------------------------------v
---------------------------XXXX-----------------------------------------------------------------XXXX|--------------------------------------------------------------------------------------------------f
--------------------------XXXXX----------------------------------------------------------------XXXXX|--------------------------------------------------------------------------------------------------f
-------------------------XXXXXX---------------------------------------------------------------XXXXXX|--------------------------------------------------------------------------------------------------f
------------------------XXXXXXX--------------------------------------------------------------XXXXXXX|--------------------------------------------------------------------------------------------------f
-------------------T---XXXXXXXX-------------------------------------------------------------XXXXXXXX|----------------------XXX----------------------------XXXXXXX--XXXXXXX-----------------------------f
--T----------------|--XXXXXXXXX------------------------------------------------------------XXXXXXXXX|------------------------------------------------------------------------------------------------?-f
m-|----------------|-XXXXXXXXXX---------------------E-----------E-------------------------XXXXXXXXXX|--------------------------------------------------------------------------------------------------X
XX|XXXXXXXXXXXXXXXX|XXXXXXXXXXXXXXXXXXXXXXXXXXXXXXXXXXXXXXXXXXXXXXXXXXXXXXXXXXXXXXXXXXXXXXXXXXXXXXXX|XXXXXXXXXXXXXXXXXXXXXXXXXXXXXXXXXXXXXXXX--------XXXX---XXXXXXXXXXXXXXXXXXXXXXXXXXXXXXXXXXXXXXXXXXXX
