--------------------------------------------------------------------------------------------------------------------------------------------------------------------------------------------------------
-----------o----------------------------------------------------------------------------------------------------------------------------------------------------------------?-------------------------B-
--------------------------------------------------------------------------------------------------------------------------------------------------------------------------------------------------------
----------------------------------------------------------------------------------------------------------------------------------------------------------------------------------------------T---------
-------------X--------------------------------------------------------------------------------------------------------------------------------------------------------------------------------|---------
------------XX---------------------------------------------------------------------------------------------------------------------------------------------------------------------?--T-------|---------
-----------XXX------------------------------------------------------------------------------------------------------------------------------------------------M-----------------------|-------|---------
----------XXXX--------------------------------------------------------------------------------------------------------------------------------------------------------------T---------|-------|--------v
---------XXXXX------------------------------------------------------------------------------------------------------------------------------------------------------------X-|---------|o------|--------f
--------XXXXXX---------------BBBB---------X---------------------------------------------------------------------------------------------------------------------------------|---------|-------|--------f
-------XXXXXXX------------o---------------XX-------------------------------------------------------------------------------------------------------------------------T------|----o----|-------|--------f
------XXXXXXXX----------------------------XXX------------------------------------------------------------------------------------------------------------------------|------|---------|--T----|--------f
-----XXXXXXXXX---------T------------------XXXX-----------------------------------------------------------------------------------------------------------------------|------|---------|--|----|--------f
----XXXXXXXXXX---------|------------------XXXXX----------------------------------------------------------------------------------------------------------------------|------|---------|--|----|--------f
m--XXXXXXXXXXXE-------E|-------E---------EXXXXXX---------------------------------------------------------------------------------------------------------------------|------|---------|--|----|--------X
XXXXXXXXXXXXXXXXXXXXXXX|MXXXXXXXXXXXXXXXXXXXXXXXXXX-----XXXXXXXXXXXXXXXXXXXXXXXXXXXXXXXXXXXXXXXXXXXXXXXXXXXXXXXXXXXXXXXXXXXXXXXXXXXXXXXXXXXXXXXXXXXXXXXXXXXXXXXXXXXXX|XXXXXX|XXXXXXXXX|XX|XXXX|XXXXXXXXX
