--------------------------------------------------------------------------------------------------------------------------------------------------------------------------------------------------------
-----------o----------------------------------------------------------------------------------------------------------------------------------------------------------------?-------------------------B-
--------------------------------------------------------------------------------------------------------------------------------------------------------------------------------------------------------
----------------------------------------------------------------------------------------------------------------------------------------------------------------------------------------------T---------
-------------T--------------------------------------------------------------------------------------------------------------------------------------------------------------------------------|---------
------------X|---------------------------------------------------------------------------------------------------------------------------------------------------------------------?--T-------|---------
-----------XX|------------------------------------------------------------------------------------------------------------------------------------------------M-----------------------|-------|---------
----------XXX|--------------------------------------------------------------------------------------------------------------------------------------------------------------T---------|-------|--------v
---------XXXX|------------------------------------------------------------------------------------------------------------------------------------------------------------X-|---------|o------|--------f
--------XXXXX|---------------BBBB---------X---------------------------------------------------------------------------------------------------------------------------------|---------|-------|--------f
-------XXXXXX|------------o---------------XX-------------------------------------------------------------------------------------------------------------------------T------|----o----|-------|--------f
------XXXXXXX|----------------------------XXX------------------------------------------------------------------------------------------------------------------------|------|---------|--T----|--------f
-----XXXXXXXX|---------T------------------XXXX-----------------------------------------------------------------------------------------------------------------------|------|---------|--|----|--------f
----XXXXXXXXX|---------|------------------XXXXX----------------------------------------------------------------------------------------------------------------------|------|---------|--|----|--------f
m--XXXXXXXXXX|E-------E|-------E---------EXXXXXX---------------------------------------------------------------------------------------------------------------------|------|---------|--|----|--------X
XXXXXXXXXXXXX|XXXXXXXXX|MXXXXXXXXXXXXXXXXXXXXXXXXXX-----XXXXXXXXXXXXXXXXXXXXXXXXXXXXXXXXXXXXXXXXXXXXXXXXXXXXXXXXXXXXXXXXXXXXXXXXXXXXXXXXXXXXXXXXXXXXXXXXXXXXXXXXXXXXX|XXXXXX|XXXXXXXXX|XX|XXXX|XXXXXXXXX
