--------------------------------------------------------------------------------------------------------------------------------------------------------------------------------------------------------
--------------------------------------------------------------------------------------------------------------------------------------------------------------------------------------------------------
--------------------------------------------------------------------------------------------------------------------------------------------------------------------------------------------------------
--------------------------------------------------------------------------------------------------------------------------------------------------------------------------------------------------------
----------------------------------------------------------------------------------------------------X---------------------------------------------------------------------------------------------------
---------------------------------------------------------------------------------------------------XX---------------------------------------------------------------------------------------------------
------------------------------X-------------------------------------------------------------------XXX---------------------------------------------------------------------------------------------------
-----------------------------XX------------------------------------------------------------------XXXX----------------------------------------------????------------------------------------------------v
----------------------------XXX-----------------------------------------------------------------XXXXX--------------------------------------------------------------------------------------------------f
---------------------------XXXX----------------------------------------------------------------XXXXXX--------------------------------------------------------------------------------------------------f
--------------------------XXXXX---------------------------------------------------------------XXXXXXX--------------------------------------------------------------------------------------------------f
-------------------------XXXXXX--------------------------------------------------------------XXXXXXXX--------------------------------------------------------------------------------------------------f
-------------------T----XXXXXXX-------------------------------------------------------------XXXXXXXXX----------------------XXX-------------------------------------XXXXXXX-----------------------------f
--T----------------|---XXXXXXXX------------------------------------------------------------XXXXXXXXXX------------------------------------------------------------------------------------------------?-f
m-|----------------|--XXXXXXXXX---------------------E-----------E-------------------------XXXXXXXXXXX--------------------------------------------------------------------------------------------------X
XX|XXXXXXXXXXXXXXXX|XXXXXXXXXXXXXXXXXXXXXXXXXXXXXXXXXXXXXXXXXXXXXXXXXXXXXXXXXXXXXXXXXXXXXXXXXXXXXXXXXXXXXXXXXXXXXXXXXXXXXXXXXXXXXXXXXXXXXXXXX--------XXXX---XXXXXXXXXXXXXXXXXXXXXXXXXXXXXXXXXXXXXXXXXXXX
