--------------------------------------------------------------------------------------------------------------------------------------------------------------------------------------------------------
--------------------------------------------------------------------------------------------------------------------------------------------------------------------------------------------------------
--------------------------------------------------------------------------------------------------------------------------------------------------------------------------------------------------------
-------------------------------------------------------------------------------------------------------------------------------------------------------------------------------------------B-o----------
------?-------------------------------------------------------------------------------------------------------------------------------------------------------------------------------------------------
--------------------------------------------------------------------------------------------------------------------------------------------------------------------------------------------------------
--------------------------------------------------------------------------------------------------------------------------------------------------------------------------------------------------------
-------------------------------------------------------------------------------------------------------------------------------------------------------------------------------------------------------v
-------------------------------------------------------------------------------------------------------------------------------------------------------------------------------------------------------f
-------------------------------------------------------------------------------------------------------------------------------------------------------------------------------------------------------f
-------------------------------------------------------------------------------------------------------------------------------------------------------------------------------------------------------f
-------------------------------------------------------------------------------------------------------------------------------------------------------------------------------------------------------f
------------------X------------------------------------------------------------------------------------------------------------------------------------------------------------------------------------f
---M-------------XX------------------------------------------------------------------------------------------------------------------------------------------------------------------------------------f
m---------------XXX-----------------------------------------------------------------------------------------------------------------------------------------------------------------E------------------X
XXXXXXXXXXXXXXXXXXXXXXXXXXXXXXXXXXXXXXXXXXXXXXXXXXXXXXXXXXXXXXXXXXXXXXXXXXXXXXXXXXXXXXXXXXXXXXXXXXXXXXXXXXXXXXXXXXXXXXXXXXXXXXXXXXXXXXXXXXXXXXXXXXXXXXXXXXXXXXXXXXXXXXXXXXXXXXXXXXXXXXXXXXXXXXXXXXXXXXXX
