---?-B--o-----------------------------------B-M---Mo--------------o---o--------XX--B----oB-B----o-------------------------------B-X-X-E-----oM--------BB----B---o-X-----------------o-M??---------------
-----o-B-X?------?--B------------o-??-----------X-E-------BM---------X---------------BE---o--B-E--BBX---E----E----------M----ooBooMXT------M-----M-----------X----------?-------X-?------E---E-----B-B--
---B--------------------X-EB--------B----?-?----M-X?----MX-----------Xo-------o---------B---?----B--E-M---?-M-----------E-o------BE-|--X---EM-E--MXE-----E--B-------X--B--?----?----E-X-------------o---
--XB------?B--------E--------B-------E------M---------?-----o--------------E----------?-------M-------X--?------------------o------?X--------B--?-------?------------oB--?--B---------------E--------?--
---------o------M-??EB---oE-----?----------o-E--o-B--?E-o----o---------?-Mo----B-------B-------B?----E--E-------o---------XX---EX------B-----B--ooX?o----M-E--M--------X-X------------?------------ME---
-----------------oo----E--------o----M--------?-----X----EM----------------------M-------o---EoB-----o-X-----B----MM-----XBo---------M-M-----------X----?-----B---?-M---X-------XM---E-----?-o-E-----E--
----------E------M---------X--B-E---X---------B-M------o-E--?-?--?-----------------M------------B---B-----BM----M--EE-B-------?--------B--X---o-o-E----oE---------M-----------B------------Bo-----??----
-?-o---?----X----------E----B-------X-----------B-----M---E--------E---o-------M--E----------E---------?-------M--X-B---M------X--------?B-E?--?---------M--------------E?----M-----------X--?--------v-
--------------o--XE-M------E------X----?---M---M-------X--B---------------------X--B-------------o-------------------M---------M--E---X-------B-o-------X--?o---?------?--?-?-----o---X-------B------Mf-
----M-M---------?E----------B------X----------E-------------------------?----?--------?-----XX--E-X-M----?-----X----?E---EX-----?---M-------MB---E-M---o--o-----M--------M--B--------?-------X--o--X--f-
------B--B--EB------------X----------------B-----M-E--X-BB-B-----E---o?-----?-o-----XB----------BXM----oX--o-M--X--o---XT-M--?----MB-?----M-o-BT?B--??-------o----?---BB-------B------E--?-B?---------f-
-----------E-X---B-M---E-M------?---------E--------X--------M--E----oM---X----XBX-------M-------o------M----o-B--X----B-|--E-M-------B-------?-|EX-------X-----o--------?X--------oB----------oo-----Ef-
----------E---X-X---?-?oXX--E------o--------oo-----o?--M-----------X--------E----E------M---?-------?-------B-X-M-------X-----?--E------oM----BXo---B------X--oE------M--B----------XE--?-M---M-----M-f-
--------------------------------------------------------------------------------------------------------------------------------------------------------------------------------------------------------
m-------------------------------------------------------------------------------------------------------------------------------------------------------------------------------------------------------
XX--XXXX-XX-XXX--X-XXXXXXXXX---X---X-XX-XXXXXX-XX-X---X--X--XXXX-XXXX---XXX-XXXXXXXXXXXXXXXXXXX-XXXXXXXXXXX-XXXXX-XXXXXX-XXXXXX--X--X-XXXXX-XXX-XXX-X--XXXXXXXXXX-XXX--XXX--XX----XXXX-XXXX-XXXXXX--X--X
