------X---o-?----Xo-----Eo---o------o-M-----E-----E---B--E-----?----------?---B-M------oBB------------M--B----M---B-----?--BB------B-----o-----o---B-E-----XB----?M---X---o------o-----B-o--------------
--X----------------B-----------M-------T----------o------B----Mo-E---------M--X-------------?--X--?-B------------E--??--XE------?--B-------E--B--E----??-----B-E?-B-----E------X--EM-X---o-B-----?------
--------------------oB-------?XM---M---|---------?-XMB-E---oX-----M-----??-----o----?------EB--E------?-------EM-M---E-Xo-------X----X---------E----?--X--E--------------oX--------o---------E----------
---E---------------M------X---M---B----XE---------?---X--------XX----------------o--------------E--------?--M---BB-----------XE------E----?o?o---B--------E--o--M---M------?X-B------X-M--Eo------------
-----------?o------X--------X------------M--??---------------?----o-------?X-X-MB-------?--o----M-M-------B-------------------X---------X-------E--------------?--B?------o---------?-B-------X-------X-
--------B---------?---------o----------X--o---B-E--E--------X------E---?-----MX----------o--------B-o------?-----B-----X----X---??--------EB--BX-?-M-----M--?E--Mo----M-M-M---X---X----B---B------o--XM-
-----------?X-----o---X----------E----X---B--?--B-------?--X-----------BB---ME----B----M-E-----------X-----------B-X-----Bo--?--X--------?-E----BX--------------X-----M-----E?--M----M-E-----o?-------X-
--M------------------o-E-?------B---------X----o-----EE--o----B--?-?o-----------------?--------o-E--?M-M-------------M------------E--o-----E-B-B----?-X--------o-EE--o-----X---X-X-----------XX--M----v-
-------------M---------o----E--X-----M------o-----X--------?X--o-o?-E---B-----o--B---X---------BMBE---o--------B--------M---M-----B---?----------B-------B-----------X----?------XEE-------?-------X--f-
-----BE-----E---?----?-------o-----?-----M------E-----------------------M-B-------------EX-o---------------E-?--oX-M----E--------------M---o--BM---B--MX--------------E----B---B---X--X-X-----T--?BM-Mf-
---------------X-----o---------------EB--|---?-M----XM-?----?o---------o--ME------oE-B---B----X--------?-------------------B-BX--?----o----X-------X?oM-------X--B-----X--?--EM------EB---?--E|-------f-
-----X--E--o-X-------------M--?-----E--?-X-X---M-E--------o------E---------M?E---E-X------?---X-?B------B--oE?---E-BM----------o-M----M----B-X-o-----oM-------------E-------------B----?--X---XB-?----f-
-BB-M---------E------?-B--------------X----X--X--E---Eo-X----------o-??-o-------o-------?--------------X---X----XMo--oXB----X-----------?---X---B?----o----M-----?---------------------Xo--o-?--?o---of-
--------------------------------------------------------------------------------------------------------------------------------------------------------------------------------------------------------
m-------------------------------------------------------------------------------------------------------------------------------------------------------------------------------------------------------
XXXXXXXX-X-XX-XX-X-----XX-X--XXXX-X-XXXXX-XX-XXX--X-XX-XX--XX---XXXXXXXX-XX-X--X-XX-X-X-XX-XXXXX-X--X--XX-X--XX------XXXXXXXX-XX-X-XX-XXXXX-X---XXXXXX-XXXX-X--XXXXX-XXXXX-XXXXXX-XXX-XX---XXXXX-X--X--X
