--o---B-BB?----------o--|--------M-----o----EE-------Boo-----------------EB--?--?B?----B--M-------o---X------B-----X-BoE-------ME-B-----E--------------?----?---------?o-------ME-------------------E---
----XX----------E------?X------------------------------E-?--E-------X---XE----BB---E-----?EB----B----?----------B-B----o-?--------------o-----?------?--?-----B----------?--M--E----M-------B-oMB-------
--M----M--------------B-----B------------------------E--?------B--------o--M---E-B--M-?---X--B----EEX-------X---------------X---------M-----B-EE----E------oM-----M----B-----E--o------o--Bo------M---E-
---oE-----M------o?--?-?X-E----Mo--------E------------EE---M------EX---M----------?-----E--B--E?----EXoE---B-B-M-o----o-----------------X---o------------X?------------o-------------M--------B-----B---
----------o---------B---------------------?-----X--B-M-----------B----------B-------M-----X-E-E----M-----X-X----?--o-?-E--------M-o---X-----------?----MX-X---XM---X--------E-B-B---M--B-?-Eo-----B-----
-M?-------------------o-----------------?------E--BE------E-o-----Bo---------------B-B-------M-o----?--?--B------X------------E-------oo-----X----------------------oo?o----------------------------o---
--o-M---M-M------B-E-----?B--o?---E--X--------------E---o----E-----------M-------M------------o-B----o-----?---E--M------------------------E----X--------?o--BE?---o-----?----E-B---B----?E-?----E------
--X---------------MX---M---B-E---?-o---?--M--------------------------B--?------M--?--X--------------------M-o---B-------------BBX-E-----X----?-----?------------------M-----------?M-o------o---------v-
---o-------EB-X-----o----E--B--------E-----E-------X-MXXX--?o-----E---------?---M-----------B----M---X-------B------------M--E-o-------M------------M------?-----M---X-M----o------X--E----o--------?-f-
--oX----M-B------o-------X-------------X------Eo?-----X------M-X-B---------E--?------EX--E------X-----??--B??-?X-?-------XE------MEM-?-----EMo----o-------X---------M------------?---BX-M---------B---f-
------M--X--E---------B------------M-o--M-B-------------E---M---B-o-----?----o--B-------M-?--?E---M-?-----E-X--------?-B-----?-B--E-----E---X-Mo-MT--E-------------------o--?---------------------X-E-f-
-E-----?-------M-----?-?-MM--B----M--EXX-M----o---?--------?--------------------EBMX-B--X---E-----X---X--o-------?M---X-------?-------------------|--o--Mo--EE--------BB-----E------------X-----------f-
--X------------------------M-------X---o-E-?---------X-o-M----?M---------E--E-B-o----o---X-?---B-------B----B--o----E----------o---------------E--X-?------X--------------------------------X---------f-
------------------------------------------------------------------------------------------------------------------------------------------------------------------------------------------------------f-
m-----------------------------------------------------------------------------------------------------------------------------------------------------------------------------------------------------X-
XXXXXXXXXXX-XX--XX----XXXX--XXX---XX-X-XXXX-X-XX-XXXXXXXX-XXXXXXXXXXXXXXX-X-XXXX-----X-XXX-X---XXXX-XX-XXXXX-X-XXXX-X--X-XXXXXXXX---XXX-X----XX-X-XXXXXX--XX--XX-XXXXXX---XX-X-XX-XXXX---XX-XX---XXXX-XX
