---------B--B----EB-?------E---E-----M-E--o---X------Mo-------------------?------o---X---?--?--E-------M--------------M---X--------M----o----o--B------X-------------B----X--X------------------o--B----
--M---B-X-X-----M--BE-----------BE--?-B-X-------X-o----o----B---M-------o--E--------------M-X--------E--------B-o--B--E?------------B-M--?X?-X--X----------E-------M-E---M-----------E----?------B---E--
----------o-----------M-----o-EB---?-------o---------BE-M-o---------?o-?---X------------------o---o-?-----B---------o-o--X---------X-E--B---------------XBB----------o-E--?---?M--------------M---------
--o----E---E------?-E?o--M---------X---o-----?--X----------B---B----o---------?----E-----XX-----?------X--------?------B-----------E-----------------------------------oX-E-----E--?-X--M-o-----------E-
---oX?E-?X-X----------X-----M---M--------------E--oMM-?---E-----B----------X-------E--B--------------o--?----------?-M--------M--B-------o--?---B--o--?----------E-----------M-----------M---X--------E-
-----o------------BM-----B---?-?---?----B----oX-----X---------X-------------?--------M-?-----E---X----------M----M--------??-?EX---o-o-----------------------------oX-----o--oX--M-----B----X---M---o---
-------oEX------o--------E-----------------BM-------------BB-M-----oM-B------X-?ME-X-------?--E--------------------M-oB------------------------MXBME------E---?-------------o-------o-----X-o--------E--
----B--|--------------------?---M---?-M------E-?-------E-E---------E-X--M----------------E--E------?-E--------BB---------X-----------X-M---?-------|--?--------X--?----M?----B-M-----B---B-M----------v-
-------X--E---E--X-B--M-B---------?----------------Bo---E--------BM-X-------M-o------X-E?-M---------M-Mo-----------?------?--o---o-------M---------X--X--ME----o---------E---E--------B----------X--?-f-
----B-X--------------M--------------M-------------E------X---------oE---------------------------?-------------X---------E-------B-----B------EB-------E--------EM--X--M-------ME----M--E-X------------f-
---M---o------------------o--M-ME--?----M--E---?-E---Eo----BX--------------XE---M--------o-----M---o------?-------MX-----?-------------BX---?---B--o-M-M---------o---M----B-------M-XB--B------M------f-
-X----------?----M--BBoM-oX-E--o------M---------B-B------X---------E---------------E--?-----B?-XM-------M-----?-----------------o----------o--E-----?-X--ME--X-o--E------M--E---M----|-B-M---------MM-f-
----o-----------------------XX----X-----o--?oB-----XX--------------X---M----E--M----E----X-B-------------------M---------EE--B------?---E-------------EBB-X------B--B----o-------ME--X---------------Mf-
------------------------------------------------------------------------------------------------------------------------------------------------------------------------------------------------------f-
m-----------------------------------------------------------------------------------------------------------------------------------------------------------------------------------------------------X-
X-XX---XX-XX-XXXX-X-XXXXXX--XXXX-XX-X-XXX-XXXXXXXXXX-X-X-XXXXXXX-X-XXXXXXX-XXXXXXXXXXXX--XXX---XXXXXXXXX--X-XX-XXXXX-XXXXX----X----XXX-XXX--XXXXXX-X--X-XXXX-X-X-XXX-X--X-XXX-X-XXX---XXXXXXX-XX---X-XXX
