?-E-ME----E-M----------X-X-?EM--------B---o---X-?-------B--?-----E-?ME-------B-?--X--------XE-------B---------XE-------------XM-----M--E-----E--?X-----?------?-----------E----------------o--oX-B--o--T
TX----------M------?-----o-----E-----M--o--X------M-EB-------?E-----o--B-?-----------X---Eo-----------XM-----M-------------X-o-------------oX---EM--EB--M--------B-o-------o-----X-?-------------------E
o-B-?-----o-X---B--------E----o--------------?---------o--E-----oE---------TM-----------------------?---------E------B----X------?-M---?------oE---?--M----?o--M---------------X---------X--M---X-------
oX------E--------o----E-X--X----?----?X--MB---?------o------M---B--?-------|-?--B-E----?-------M---E--?E-M------------oX----------------?------o--MM-------B---o----------------BB--M-------E----------T
T----------EX----X-M-E--E---------B---o---oX-------?--------o-----------o-BX-X-------B----X---------B--------MM-B-M--------oB----------B--?o----X?-----?M-----------E------X------------E----------oX--?
|--B-?--?B-----------o-----B-----B------------X---Eo---?---------?------X----M--?--E---B-----B--X-----------XE------M--E--B------M---------B------Eo---o----------X-------------B--------X-BBB------MM-?
E-----XoE-------------X-----------o--B-o-------?----X--------B---------?-------Bo----------------------X-------------X-----o-M-----?E---M-B-B----EX--B------XM---?X-B---B-----M------------------?-----T
B?-M------E-B---o----o-M-----?-------------?oX---------------M---------M--------------?--E-?-M---o-EE-X--?--E-M------------MoMM-BX----B--oM----M-------------------------MM---E---?---?E-X--?------E--vo
|E------E-M----?--------oX--?B-----E---E-----------------------BM------------------X----B----E---------?--B---X------MM--X--B---B-X-----------E--?--XM-M--------------?---M---B--------X-X--EX--E-----f|
o--X---X--------o---------------------------?B-----------M-------X-------------------?------B-M-M-X-------E--Mo-----------------------?--ooB---X?--------B-------?--o----------------B-B-------E---B-MfB
M-----?B---------------X----------B----o--M------o-------E---BX---------M----E----o---MB--?--M---B------------X-Eo--------B----E----------------X---M-EE---E------B-------B--?-?--------------X-o-----fT
-E-----o-----------E-B------M-------?---X-------E-?------Eoo--B--------------------X------------------------------B-XXE-M----------M--------?M--o-----o--?oM-X-------M-----------------EX------B---M--fM
|------------------------------------------------------------------------------------------------------------------------------------------------------------------------------------------------------X
B-------------------------------------------------------------------------------------------o-----------o----------------------------------------------------------------------------------------------B
m----------------------------------------------------------------------o-----------o---E---------------------------------------------------------------------------------------------------------------|
XXXX-XXXXXXX-XX-X----XXXXXXXX--X-XXXXX-XX-XXXXX-XXX-X-X-XXXXX--XXX-XXXX--XXXXXXX-X--XXX--XXX-XXX--XXXXXX-XXXXXXXX-XXX-X-X--XXXXX-XX--XX-XXXX--XXXXX-X-XXX-X--X--X-XX--XXXXXXX-X-XX---XXXXXXXX----X--X--X
